1111111111
1000100001
1000100001
1000101101
1000001001
1011111011
1001000001
1001101001
1000000101
1001111101
1000000001
1011111101
1010100101
1010000$01
1111111111
-LEVEL  1-